song_t	KEYWORD3
time_t	KEYWORD3


begin	KEYWORD2
manualBegin	KEYWORD2
end	KEYWORD2
playSong	KEYWORD2
songTick	KEYWORD2
stToFreq	KEYWORD2
stToInterval	KEYWORD2
tick	KEYWORD2
tickType	KEYWORD2
restart	KEYWORD2

curSong	KEYWORD2
isEnded	KEYWORD2


Song	KEYWORD1

SONG_END	LITERAL1
SONG_LOOP	LITERAL1
SONG_SETDELAY	LITERAL1
SONG_WAIT	LITERAL1

TICK_NORMAL	LITERAL1
TICK_NORMALEQ	LITERAL1
TICK_FULL	LITERAL1
TICK_FULLEQ	LITERAL1
